VVVV%%%%%%///2)))2)))2)))2)))2)))2)))2)))2)))2)))2))))))))))ô7-[
VVVVVV#############################################XXXXXX)))ô7U-
VVVVVVV-----------2222222222222222222222222222222)))))))))))ô777
<VVVVVVVOOOOOOOOO--222222222222222222222))))))--------------ôôôô
666VVVVVVVOOOOOOOO--22222222222222222222)##DD##H++++++++++++++++
8888VVVVVVVOOOOOOOO--22222222B2222222222)##DD###################
    2VVVVVVVKOOOOOOO-2222222222222222222)##DD`-----2---C-I--.-]ñ
 666   VVVVVVVVOOOOO-2222222222222222222)##DD###################
 6U6    VVVVVVVVOOOO-2222222222222222222)##(((((*(E(4MMMMMMMM444
 666  P  VVVVVVVVOOO-2222222222222222222)##((*((((E(4MMMMMMMM4LL
            VVVVVVVO-----------222222222)##(((((((E*4MMMMMMMM444
             VVVVVVVVXXXXXXXXX-222222222-#######################
 2      2     VVVVVVVVXXXXXXXX-222222222------T------2--2--2-]òK
###             VVVVVVVV888XXX-222222222-#######################
22####        2   VVVVVVV"8XXX-222222222))))))-----)))))))))))))
222C               VVVVVVV8XXX-222222222222222-555-222222222222)
222C     2           VVVVVVXXX-222222222222222-5K5-222222222222)
22####       //   2   VVVVVVXX-222222222222222-555-222222222222)
###        /////      VVVVVVVX-222222222222222-----222222222222)
!   2     ///>///      VVVVVVV-22222222222222222222222222222222)
ööö        /////       VVVVVVVV)))))))))))))))))))))))))))))))))
99ööööö    * //        VVVVVVVVV)))))######################88###
|9.....          2     VóVVVVVVVV))))888888888888Q888888888888õK
