<3333333333333333333333333333333#K#OOOOOOOOOOOOOOOOOOOó33333333[
33333333333333333333333333333333#ô#33333333333333333333333333333
33333333333333333333333333333---#H#33333333333333333333333333333
33333333336666663333333333333-U-#4#33333333333333333333333333333
33333333336%W%W63333333333333---#4#33333333333################33
33333333336W%W%63333333333333333#4#3333333333?#11111111111111#33
33333333336%W%W63333333333333333#4#-###########/\//////\/////##-
33333333336666663333333333333333#4#-#**********/////\/\///\//\/-
33333333333333333333333333333333#4#-#**********\//\//////\/////-
--3333333333333333333333333333355555###########################-
K-333333333333333333333333333335T.T5#C-B--------B--------B------
###############################5.P.5############################
#chamber#of#horror#3333333333335T.T5XXXXXXXXXXXXXXXXXXXXXXXXXX--
###################33333333333355555XXXXXXXXXXXXXXXXXXXXXXXXXX-K
33333333333333333333333333333333#7##############################
33333333333333333333333333333333#7#K-MMMMMMMXWWWWWWWWWWWWWWWWWWW
3333---333333333B333333333333333#7#--MMMMMMMX3333333333333333333
3333-K-3333333333333333333333333#7#MMMMMMMMMX3333333333333333333
3333---333333333333333###########7#MMMMMMMMMX3333333333333333333
3333333333333333333333#WWWWWE%%%#7#MMMMMMMMMX3333333333333333333
3333333333333333333333#WWWWW#####ô#MMMMMMMMMX333333333---3333333
3333###################-#####* !#ñ#MMMMMMMMMX333333333-U-3333333
|33388888888888888DDDDD-õDLL#  ò#K#MMMMMMMMMX333333333---333333"
